ALEX	AE L AH K S
AM	AE M
AM(2)	EY EH M
ARM	AA R M
AT	AE T
CHARLIE	CH AA R L IY
CHOCOLATE	CH AO K L AH T
COKE	K OW K
DRINK	D R IH NG K
ELIZABETH	IH L IH Z AH B AH TH
ELIZABETH(2)	IH L IH Z AH B IH TH
FAVOURITE	F EY V ER IH T
FIND	F AY N D
FOLLOW	F AA L OW
FRANCIS	F R AE N S AH S
FRANCIS(2)	F R AE N S IH S
GRAB	G R AE B
GRAPE	G R EY P
HELLO	HH AH L OW
HELLO(2)	HH EH L OW
HI	HH AY
I	AY
IS	IH Z
JAMES	JH EY M Z
JENNIFER	JH EH N AH F ER
JOHN	JH AA N
JUICE	JH UW S
LEFT	L EH F T
LIKE	L AY K
LINDA	L IH N D AH
LOCATE	L OW K EY T
MARY	M EH R IY
MEET	M IY T
MICHAEL	M AY K AH L
MY	M AY
NAME	N EY M
ORANGE	AO R AH N JH
ORANGE(2)	AO R IH N JH
PATRICIA	P AH T R IH SH AH
POINT	P OY N T
POINTING	P OY N T IH NG
PREFER	P R AH F ER
PREFER(2)	P R IH F ER
PREFER(3)	P R IY F ER
RAISING	R EY Z IH NG
RIGHT	R AY T
ROBERT	R AA B ER T
ROBIN	R AA B AH N
ROBIN(2)	R AA B IH N
SKYLER	S K AY L AH R
SPRITE	S P R AY T
THE	DH AH
THE(2)	DH IY
THEIR	DH EH R
TO	T UW
TO(2)	T IH
TO(3)	T AH
WAVING	W EY V IH NG
WILLIAM	W IH L Y AH M
