AM	AE M
AM(2)	EY EH M
AN	AE N
AN(2)	AH N
AND	AH N D
AND(2)	AE N D
ANDREW	AE N D R UW
BYE	B AY
CAN	K AE N
CAN(2)	K AH N
CHICKEN	CH IH K AH N
DONE	D AH N
FOR	F AO R
FOR(2)	F ER
FOR(3)	F R ER
FRANCISCO	F R AE N S IH S K OW
GOODBYE	G UH D B AY
I	AY
IS	IH Z
LIKE	L AY K
MY	M AY
NAME	N EY M
NICK	N IH K
ORDER	AO R D ER
OSMAN	AA S M AH N
PASTA	P AA S T AH
PLACE	P L EY S
READY	R EH D IY
RICE	R AY S
SALAD	S AE L AH D
SPAGHETTI	S P AH G EH T IY
STEAK	S T EY K
TO	T UW
TO(2)	T IH
TO(3)	T AH
WANT	W AA N T
WANT(2)	W AO N T
WATER	W AO T ER
WOULD	W UH D
