ALEX	AE L AH K S
APPLE	AE P AH L
BAG	B AE G
BASKET	B AE S K AH T
BOWL	B OW L
BRING	B R IH NG
CEREAL	S IH R IY AH L
CHARLIE	CH AA R L IY
CLEMENT	K L EH M AH N T
CLOTH	K L AO TH
COKE	K OW K
CRACKERS	K R AE K ER Z
CUP	K AH P
DISH	D IH SH
ELIZABETH	IH L IH Z AH B AH TH
ELIZABETH(2)	IH L IH Z AH B IH TH
FIND	F AY N D
FORK	F AO R K
FRANCIS	F R AE N S AH S
FRANCIS(2)	F R AE N S IH S
FRANCISCO	F R AE N S IH S K OW
GLASS	G L AE S
GRAPE	G R EY P
HELLO	HH AH L OW
HELLO(2)	HH EH L OW
IS	IH Z
JAMES	JH EY M Z
JENNIFER	JH EH N AH F ER
JOHN	JH AA N
JUICE	JH UW S
KNIFE	N AY F
LINDA	L IH N D AH
MARY	M EH R IY
ME	M IY
MEET	M IY T
MICHAEL	M AY K AH L
MY	M AY
NAME	N EY M
NICK	N IH K
NOODLES	N UW D AH L Z
ORANGE	AO R AH N JH
ORANGE(2)	AO R IH N JH
OSMANN	AA Z M AH N
PAPRIKA	P AE P R IY K AH
PAPRIKA(2)	P AH P R IY K AH
PATRICIA	P AH T R IH SH AH
PRINGLES	P R IH N G AH L Z
ROBERT	R AA B ER T
ROBIN	R AA B AH N
ROBIN(2)	R AA B IH N
SAUSAGES	S AO S IH JH IH Z
SIMAR	S AY M AH R
SKYLER	S K AY L AH R
SPONGE	S P AH N JH
SPOON	S P UW N
SPRITE	S P R AY T
THE	DH AH
THE(2)	DH IY
TRAY	T R EY
WILLIAM	W IH L Y AH M
