ABORT	AH B AO R T
AHEAD	AH HH EH D
BACK	B AE K
BACKWARD	B AE K W ER D
CONTINUE	K AH N T IH N Y UW
DOWN	D AW N
FASTER	F AE S T ER
FORWARD	F AO R W ER D
HALF	HH AE F
HALT	HH AO L T
KILL	K IH L
LEFT	L EH F T
OFF	AO F
PANIC	P AE N IH K
PAUSE	P AO Z
QUARTER	K W AO R T ER
RIGHT	R AY T
ROTATE	R OW T EY T
SHUT	SH AH T
SLOW	S L OW
SLOWER	S L OW ER
SPEED	S P IY D
STOP	S T AA P
STRAIGHT	S T R EY T
TURN	T ER N
UP	AH P
VOICE	V OY S
